 * * * * * * * * * * * * * * *
*                             *
*   a                         *
*                             *
*                        a    *
*                             *
*                             *
*                             *
*                             *
*                             *
*                         a   *
*                             *
*          p                  *
*                             *
*                             *
*                             *
*                             *
*                             *
*                             *
*                             *
*                             *
*                             *
*                             *
*                             *
*                             *
*                             *
*                             *
*                             *
*                             *
*                             *
*                    c        *
 * * * * * * * * * * * * * * *
