*****************
*               *
*  a            *
*               *
*            a  *
*               *
*               *
*               *
*               *
*    p          *
*              a*
*               *
*               *
*               *
*               *
*               *
*               *
*               *
*               *
*               *
*               *
*               *
*               *
*          c    *
*****************
